..........................
..........................
..........................
..........................
..........................
..........................
..........................
..........................
..........................
.@......DDD.....D.........
DDDDDDDD###DDDDD#DDDDDDDDD
##########################
##########################
##########################
##########################